1111111111111111111111111111111111
1E0M00000000000C00000C000000000P01
101001010010000M101001000000010101
10100100101010100010010000M0010101
100000000C00C00000000000M000000PC1
1111111111111111111111111111111111