1111111111111111111111111111111111
1E0M00000000000C10000C000000000001
101001010010000M101001000000010101
10100100101010101010010000M0010101
10P000000C00C000100P0000M000000PC1
1111111111111111111111111111111111