11111111111111111111111111111111111111111111111111111111111111111111
1E0M00000000000C10000C000000000000000M00000000000C00000C000000000001
101001010010000M101001000000010100001001010010000M001001000000010101
10100100101010101010010000M001010000100100101010100010010000M0010101
100000000C00C000100P0000M0000000C0000000000C00C00000000000M0000000C1
11111111111111111111111111111111111111111111111111111111111111111111